*   * * * * * *   * *   *   * * * *    
  * * * * * * * * * * *   * * * * * *  
* * * * * * * * * * * * * * * * * * * *
* * * * * * * * * * * * * * * * * * * *
* * * * * * * * * * * * * * * * * * * *
  * * * * * * * * * * * * * * * *   * *
* * * * * * *   * * * * * * *   *   * *
* * * * *           * * * * *       * *
  * * * *   * * *   * *         *   *  
  * * *       * *         * * * *   *  
* * * * * * * * *   * * * * * * *   * *
* * * * * * * * *   * * * * * * *   * *
* * * * * * * * *   * * * * * * *   * *
* * * * * * * * *   * * * *   * *   * *
* * * * * * * * *   * * *     * *   * *
* * * * * * * * *          *        * *
* * * * * * * * *   * * * * * * *   *  
* * * * * * * * *                   * *
* * * * * * * * * * * * * * * * * * * *
S G * * * * * *   * * * * * * * * * * *
