.   . . . . . .   . .   .   . . . .    
  . . . . . . . . . . .   . . . . . .  
. . . . . . . . . . . . . . . . . . . .
. . . . . . . . . . . . . . . . . . . .
. . . . . . . . . . . . . . . . . . . .
  . . . . . . . . . . . . . . . .   . .
. . . . . . .   . . . . . . .   .   . .
. . . . .           . . . . .       . .
  . . . .   . . .   . .         .   .  
  . . .       . .         . . . .   .  
. . . . . . . . .   . . . . . . .   . .
. . . . . . . . .   . . . . . . .   . .
. . . . . . . . .   . . . . . . .   . .
. . . . . . . . .   . . . . S . .   . .
. . . . . . . . .   . . .     . .   . .
. . . . . . . . .          .        . .
. . . . . . . . .   . . . . . . .   .  
. . . . . . . . .   G               . .
. . . . . . . . . . . . . . . . . . . .
  . . . . . .   . . . . . . . . . . .
