*   * * * * * * * * *   *   * * * * * *
  * * * * * * * * * * *   * * * * * *
* * * * * * * * * * * * * * * * * * * *
* * * * * * * * * * * * * * * * * * * *
* * * * * * * * * * * * * * * * * * * *
* * * * * * * * * * * * * * * * *   * *
* * * * * * *   * * * * * * *   *   * *
* * * * *           * * * * *       * *
* * * * *   * * *   * *         *   * *
* * * * S     * *         * * * *   * *
* * * * * * * * *   * * * * * * *   * *
* * * * * * * * *   * * * * * * *   * *
* * * * * * * * *   * * * * * * *   * *
* * * * * * * * *   * * * *   * *   * *
* * * * * * * * *   * * * *   * *   * *
* * * * * * * * *                   * *
* * * * * * * * * * * * * * * * *   * *
* * * * * * * * * * * * * * * * * G * *
* * * * * * * * * * * * * * * * * * * *
* * * * * * * * * * * * * * * * * * * *
